Hello World
Hello Kitty
                        +&-
                           _.-^-._    .--.
                        .-'   _   '-. |__|
                       /     |_|     \|  |
                      /               \  |
                     /|     _____     |\ |
                      |    |==|==|    |  |
  |---|---|---|---|---|    |--|--|    |  |
  |---|---|---|---|---|    |==|==|    |  |
 ^^^^^^^^^^^^^^^^^^^^^^^^^^^^^^^^^^^^^^^^^^
